1111111111111
10000000000C1
1000111010001
1P0C11E00C001
1111111111111
