1111111111111
10T00000000C1
1000111110001
1P0C11E00CT01
1111111111111
1111111111111
10T00000000C1
1000111110001
1P0C11E00CT01
1111111111111
